AAAAAAAAAAAAA
AAEEEEEEEEEAA
AAESSSSSSSEAA
AAEWSSWSSSEAA
AAESWSSWSWEAA
AAESSSSSSSEAA
AAESWSSSSSEAA
AAESSSSWSSEAA
AAESSSSSSSEAA
AAEEEEEEEEEAA
AAAAAAAAAAAAA