EEEEEEEEE
ESSSSSSSE
EWSSWSSSE
ESWSSWSWE
ESSSSSSSE
ESWSSSSSE
ESSSSWSSE
ESSSSSSSE
EEEEEEEEE
