SSWSSWSSS
SSSWSSSSS
SSSSSSSSS
SSWSSWWSS
SSESSESSS
SSSSSSSSS
SSESESESS
SSSSSSSSS
EEEEEEEEE