WSSSSWSSW
WSSSSSSEW
EWSSWSESE
SSWSSWEWS
SSESSESSS
WSSSSSSSW
SSESESESW
WSSSSSSSW
WEWSSSSSW