EEEEEEEEE
ES1SWS4SE
ESSSSSSSE
ESWSPSWSE
ESPSPSPSE
ESWSSSWSE
ESSSPSSSE
ES3SWS2SE
EEEEEEEEE