EEEEEEEEE
ESSSSSSSE
EWSSWSSSE
ESWSSWSWE
ESSSSSSSE
ESSSSSSSE
ESSSSSSSE
ESSSSSSSE
EEEEEEEEE