SSWSSWSSS
SSSWSSSWS
SESSESSSS
SSWSSWWSS
SSESSESSS
SSSSSSSSS
SWESESESS
SSSSWSSWS
WWWSSSWSS