EEEEEEEEE
E1W3W4W2E
ESSSWSSSE
ESWSSSWSE
ESSSSSSSE
ESSSSSSSE
ESPPPPPSE
ESSSSSSSE
EEEEEEEEE
