EEEEEEEEE
ES1SSS4SE
EWSPWSSSE
ESWPSWSWE
ESS2SPSSE
ESWSSS3SE
ESSPSWSSE
EPSSSSPSE
EEEEEEEEE
