EEEEEEEEE
ES1SSS4SE
EWSSWSSSE
ESWPSWSWE
ESS2SPSSE
ESWSSS3SE
ESSPSWSSE
EPSSSSSPE
EEEEEEEEE
